Angriff + %@: %@	Schaden gg. %@ erhöht.
Verteidigung + %@: %@	Schaden durch %@ gesenkt.
"Stark"-Effekt + %@: %@	"Stark"-Effekt verbessert gg. %@
Heftiger Schaden +%@: %@	Schaden verbessert gg. %@
„Stark“-Effekt + %@: %@	Resistenz gegen %@-Angriffe verbessert.
Mini-Todes-Zufallsangriff %@	Entfesselt bei Tod einen Mini-Zufallsang.<br>Nach je 2 Eins. verfügbar (nicht stapelbar).
Wellenschaden-Resistenz %@	Verringert Schaden durch feindl. Wellenang.
Skonto %@	Erstattet einen Teil der Einsatzkosten einer gefallenen Katze.<br>Nach je 2 Eins. verfügbar.
Rückstoß-Resistenz %@	Verringert den Effekt feindl. Rückst.-Angr.
Legenden-Level stärken %@	Ges. & Angr. in Legenden-Leveln erhöht (nicht stapelbar).
Kolosstöter %@	Fähigk. Kolosstöter nach je 2 Eins. verfügbar (nicht stapelbar).
Katzenkanonenaufl. %@	Wird eine Katze besiegt, lädt die Kanone auf.<br>Nach je 2 Eins. verfügbar (nicht stapelbar).
Gift-Resistenz %@	Verringert Schaden durch<br>feindliche Giftangriffe.
Angriff ausweichen (alle) %@	Gewährt allen anderen eingesetzten Katzen<br>die Fähigkeit „Angriff ausweichen (alle)“.
Lähmung-Resistenz %@	Verringert Schaden durch<br>feindliche Lähmungsangriffe.
Fluch-Resistenz %@	Verringert Schaden durch<br>feindliche Fluchangriffe.
Unheimliche Legenden verstärken %@	Ges. & Angr. in Unheimlichen Legenden<br>erhöht (nicht stapelbar).
Konter: 1x Zufallsangriff %@	Kontere immer nach zwei Einsätzen mit einem<br>Zufallsangriff, wenn du von einem gegnerischen<br>Zufallsangriff getroffen wirst (nicht stapelbar).
Berserker %@	Erhöht die Angriffskraft, nachdem eine<br>bestimmte Anzahl Feinde<br>besiegt wurde (nicht stapelbar).
Verkürzte Abklingzeit %@	Verkürzt alle zwei Einsätze<br>die Abklingzeit (nicht stapelbar).
Einfrieren-Resistenz %@	Verringert den Einfrieren-Effekt<br>feindlicher Angriffe.
Schwächen-Resistenz %@	Verringert den Schwächen-Effekt<br>feindlicher Angriffe.